***************************************************
*                                                 *
************************************************* *
* *************************************************
* *                                               *
* *                                               *
* *                                               *
* *                                               *
* *************************************************
************************************************* *
*                                                 *
*   ******************************************    *
*  ********************************************   *
* **********************************************  *
*                                               $ *
***************************************************